#############
#...........#
#.#.#.#.#.#.#
#...........#
#.#.#.#.#.#.#
#...........#
#.#.#.#.#.#.#
#...........#
#.#.#.#.#.#.#
#...........#
#############