#############
#...........#
#.#.#.#.#.#.#
#...........#
#.#.#.#.#.#.#
#...........#
#.#.#.#.#.#.#
#...........#
#.#.#.#.#.#.#
#....**.....#
#############